11111111111111111111111111111111
11111111111100000000000000000001
11111111111100000000000000000001
11111111111100000000000000000001
11111111111100000000000000000001
11111111111100000000000000000001
11111111111100000000000000000001
11111111111100000000000000000001
11111111111100000000000000000001
11111111111100000000000000000001
11111111111100000000000000000001
1111111111110000000000P000000001
11111111111100000000000000000001
11111111111100000000000000000001
11111111111100000000000000000001
11111111111100000000000000000001
11111111111100000000000000000001
11111111111100000000000000000001
11111111111100000000000000000001
11111111111100000000000000000001
11111111111100000000000000000001
11111111111100000000000000000001
11111111111100000000000000000001
11111111111111111111111111111111
